content/posts/what-is-the-safest-space-heater.md	what-is-the-safest-space-heater
content/posts/5-best-tiny-house-heaters-gas-electric-wood.md	best-tiny-house-heaters
content/posts/what-s-the-best-space-heater-brand.md	whats-the-best-space-heater-brand
content/posts/do-air-conditioners-wear-out-high-vs-low-maintenance.md	do-air-conditioners-wear-out
content/posts/dyson-f4-error-code-how-to-fix-it.md	fix-dyson-f4-error-code
content/posts/5-best-wood-workshop-heaters-gas-electric.md	best-wood-workshop-heaters
content/posts/how-to-improve-oil-filled-radiator-efficiency.md	how-to-improve-oil-filled-radiator-efficiency
content/posts/4-best-basement-heaters-gas-electric.md	best-basement-heaters
content/posts/how-to-fix-swamp-cooler-smell.md	how-to-fix-swamp-cooler-smell
content/posts/are-coway-airmega-air-purifiers-worth-it-critical-review.md	are-coway-airmega-air-purifiers-worth-it
content/posts/how-to-heat-a-van-in-winter.md	how-to-heat-a-van-in-winter
content/posts/are-mr-heaters-safe-in-a-tent-fact-checked.md	are-mr-heaters-safe-in-a-tent
content/posts/space-heater-or-hot-water-bottle-9-differences.md	space-heater-or-hot-water-bottle-9-differences
content/posts/14-cheapest-ways-to-cool-a-garage.md	cheapest-ways-to-cool-a-garage
content/posts/can-you-run-a-space-heater-off-a-generator.md	can-you-run-a-space-heater-off-a-generator
content/posts/dyson-humidify-cool-fans-are-they-worth-it.md	are-dyson-humidify-cool-fans-worth-it
content/posts/3-best-swamp-coolers-for-bedrooms.md	best-swamp-coolers-for-bedrooms
content/posts/space-heaters-that-don-t-blow-fuses-our-5-top-picks.md	space-heaters-that-dont-blow-fuses-our-5-top-picks
content/posts/do-infrared-heaters-need-to-be-vented.md	do-infrared-heaters-need-to-be-vented
content/posts/diesel-heater-e08-error-code-how-to-fix-it.md	fix-diesel-heater-e08-error-code
content/posts/do-air-purifiers-need-water.md	do-air-purifiers-need-water
content/posts/how-to-fix-an-air-purifier-not-collecting-dust.md	how-to-fix-an-air-purifier-not-collecting-dust
content/posts/lasko-heater-keeps-shutting-off-3-causes-and-fixes.md	lasko-heater-keeps-shutting-off
content/posts/dyson-wrong-air-quality-temperature-how-to-fix-it.md	fix-dyson-wrong-air-quality-temperature
content/posts/how-long-can-you-leave-a-space-heater-on.md	how-long-can-you-leave-space-heater-on
content/posts/how-to-heat-a-garage-gym-the-21-best-ways.md	how-to-heat-a-garage-gym-the-21-best-ways
content/posts/are-space-heaters-allowed-in-dorms.md	are-space-heaters-allowed-in-dorms
content/posts/how-to-remove-smell-in-a-portable-ac.md	how-to-remove-smell-in-portable-ac
content/posts/is-a-single-hose-or-dual-hose-ac-better.md	is-a-single-or-dual-hose-portable-ac-better
content/posts/why-your-air-purifier-smells-musty-wet-dog-fish-etc.md	why-your-air-purifier-smells
content/posts/how-to-reset-the-f-code-on-a-dyson-air-purifier.md	how-to-reset-the-f-code-on-a-dyson-air-purifier
content/posts/how-to-build-a-terracotta-clay-pot-heater.md	how-to-build-a-terracotta-clay-pot-heater
content/posts/which-space-heater-size-do-you-need.md	which-space-heater-size-do-you-need
content/posts/which-air-conditioner-type-is-best-for-a-garage-1-2-3-4-cars.md	which-air-conditione-type-is-best-for-garage
content/posts/can-you-run-an-air-purifier-with-a-window-open.md	can-you-run-air-purifier-with-window-open
content/posts/5-best-ventless-propane-heaters.md	best-ventless-propane-heaters
content/posts/dyson-deep-clean-cycle-not-working-how-to-fix-it.md	fix-dyson-deep-clean-cycle-not-working
content/posts/what-size-generator-can-run-a-heat-pump.md	what-size-generator-can-run-a-heat-pump
content/posts/how-to-fix-a-honeywell-space-heater-not-working.md	how-to-fix-a-honeywell-space-heater-not-working
content/posts/do-you-have-to-put-water-in-a-portable-air-conditioner.md	put-water-in-portable-air-conditioner
content/posts/dyson-humidify-cool-not-humidifying-how-to-fix-it.md	fix-dyson-humidify-cool-not-humidifying
content/posts/dyson-f2-error-code-how-to-fix-it.md	fix-dyson-f2-error-code
content/posts/does-radiant-floor-heating-add-value-to-your-home.md	does-radiant-floor-heating-add-value-to-home
content/posts/swamp-cooler-not-blowing-cold-air-8-fixes.md	swamp-cooler-not-blowing-cold-air
content/posts/coway-air-purifier-indicator-lights-meanings-colors-blinking.md	coway-air-purifier-indicator-lights-meanings-colors-blinking
content/posts/can-you-run-a-swamp-cooler-without-water.md	can-you-run-a-swamp-cooler-without-water
content/posts/diesel-heater-e10-error-code-3-causes-and-fixes.md	fix-diesel-heater-e10-error
content/posts/3-best-portable-air-conditioners-for-garages.md	best-portable-air-conditioners-for-garage
content/posts/dyson-fan-not-cooling-5-fixes.md	dyson-fan-not-cooling-fixes
content/posts/heat-storm-heater-not-working-how-to-fix-it.md	fix-heat-storm-heater-not-working
content/posts/does-putting-ice-in-a-swamp-cooler-make-sense.md	does-ice-in-a-swamp-cooler-make-sense
content/posts/are-dyson-heaters-energy-efficient-running-cost-of-hot-cool.md	are-dyson-heaters-energy-efficient-a-critical-review
content/posts/how-to-make-a-window-ac-more-efficient-9-methods.md	how-to-make-a-window-ac-more-efficient
content/posts/how-to-fix-a-portable-air-conditioner-not-cooling.md	how-to-fix-portable-air-conditioner-not-cooling
content/posts/are-dyson-cooling-fans-worth-it.md	are-dyson-cooling-fans-worth-it
content/posts/infrared-vs-radiant-heaters-are-they-the-same.md	infrared-vs-radiant-heaters-are-they-the-same
content/posts/how-to-remove-mold-in-a-portable-air-conditioner.md	remove-mold-portable-air-conditioner
content/posts/space-heater-keeps-shutting-off-5-reasons-and-how-to-fix-it.md	space-heater-keeps-shutting-off
content/posts/best-car-camping-heaters-for-winter.md	best-car-camping-heaters-for-winter
content/posts/can-a-swamp-cooler-run-all-day.md	can-a-swamp-cooler-run-all-day
content/posts/are-portable-air-conditioners-safe.md	are-portable-air-conditioners-safe
content/posts/can-you-use-an-extension-cord-with-a-portable-air-conditioner.md	can-you-use-extension-cord-with-portable-air-conditioner
content/posts/how-to-heat-a-boat-cabin-without-electricity.md	how-to-heat-a-boat-cabin
content/posts/7-best-air-conditioners-for-small-rooms.md	best-air-conditioners-for-small-rooms
content/posts/are-pelonis-heaters-energy-efficient.md	are-pelonis-heaters-energy-efficient
content/posts/are-dyson-heaters-noisy-a-critical-review.md	are-dyson-heaters-noisy
content/posts/diesel-vs-propane-heater-which-to-pick-5-differences.md	diesel-vs-propane-heater
content/posts/are-any-space-heaters-made-in-the-usa.md	are-any-space-heaters-made-in-the-usa
content/posts/do-portable-air-conditioners-need-to-be-vented.md	do-portable-air-conditioners-need-to-be-vented
content/posts/space-heaters-over-1-500-watts-electric-gas.md	space-heaters-over-1500-watts
content/posts/best-air-purifier-my-top-pick.md	best-air-purifier
content/posts/how-to-assemble-an-oil-heater-picture-manual.md	how-to-assemble-an-oil-heater
content/posts/air-purifier-running-cost-the-ultimate-guide.md	air-purifier-running-cost-guide
content/posts/best-space-heaters-under-50-a-complete-guide-to-the-cheapest-ones.md	best-space-heaters-under-50-a-complete-guide-to-the-cheapest-ones
content/posts/bluegrass-living-propane-heater-review-strong-reliable.md	bluegrass-living-propane-heater-review
content/posts/diesel-vs-electric-rv-heaters-which-to-pick.md	diesel-vs-electric-rv-heaters
content/posts/can-you-plug-a-space-heater-into-a-timer.md	can-you-plug-a-space-heater-into-a-timer
content/posts/can-you-use-an-oil-filled-radiator-in-a-bathroom.md	can-you-use-an-oil-filled-radiator-in-a-bathroom
content/posts/mr-heater-ceramic-burner-tile-replacement-in-6-steps.md	mr-heater-ceramic-burner-tile-replacement
content/posts/how-much-does-an-oil-filled-radiator-weigh.md	how-much-does-an-oil-filled-radiator-weigh
content/posts/3-best-vented-gas-heaters.md	best-vented-gas-heaters
content/posts/can-solar-panels-heat-a-house.md	can-solar-panels-heat-a-house
content/posts/electric-fireplace-not-working-tried-tested-fixes.md	electric-fireplace-not-working
content/posts/why-your-air-purifier-is-not-removing-odors-fixes.md	air-purifier-not-removing-odors-fixes
content/posts/how-long-does-a-wood-stove-take-to-heat-up.md	how-long-does-a-wood-stove-take-to-heat-up
content/posts/how-to-fix-a-dyson-heater-not-blowing-hot-air.md	how-to-fix-a-dyson-heater-not-blowing-hot-air
content/posts/4-best-fanless-heaters.md	best-fanless-heaters
content/posts/5-space-heaters-with-long-cords-ranked-reviewed.md	5-space-heaters-with-long-cords-ranked-reviewed
content/posts/where-do-swamp-coolers-work-us-states-list.md	where-do-swamp-coolers-work-us-states
content/posts/do-infrared-heaters-heat-the-air.md	do-infrared-heaters-heat-the-air
content/posts/can-you-use-an-oil-filled-radiator-in-an-rv.md	can-you-use-an-oil-filled-radiator-in-an-rv
content/posts/do-heat-pumps-dry-the-air.md	do-heat-pumps-dry-the-air
content/posts/are-propane-heaters-safe-indoors.md	are-propane-heaters-safe-indoors
content/posts/best-space-heaters-for-rooms-with-high-ceilings.md	best-space-heaters-for-rooms-with-high-ceilings
content/posts/can-you-get-a-tan-from-a-space-heater.md	can-you-get-a-tan-from-a-space-heater
content/posts/can-you-use-a-propane-heater-in-an-rv.md	can-you-use-a-propane-heater-in-an-rv
content/posts/3-most-powerful-portable-air-conditioners.md	most-powerful-portable-air-conditioners
content/posts/how-to-fix-a-dyson-heater-not-turning-on.md	how-to-fix-a-dyson-heater-not-turning-on
content/posts/wood-stove-not-getting-hot-12-fixes.md	wood-stove-not-getting-hot
content/posts/do-portable-air-conditioners-need-regassing.md	do-portable-air-conditioners-need-regassing
content/posts/are-dyson-heaters-safe-a-critical-review.md	are-dyson-heaters-safe
content/posts/how-does-a-portable-air-conditioner-work.md	how-does-a-portable-air-conditioner-work
content/posts/4-best-child-safe-heaters.md	best-child-safe-heaters
content/posts/how-to-fix-a-mr-heater-buddy-not-lighting.md	how-to-fix-a-mr-heater-buddy-not-lighting
content/posts/how-to-fix-a-coway-air-purifier-not-working-repair-guide.md	how-to-fix-a-coway-air-purifier-not-working
content/posts/how-to-make-an-infrared-heater-more-efficient.md	how-to-make-an-infrared-heater-more-efficient
content/posts/best-swamp-cooler-my-top-pick.md	best-swamp-cooler
content/posts/how-do-convection-heaters-work.md	how-do-convection-heaters-work
content/posts/3-best-programmable-space-heaters.md	best-programmable-space-heater
content/posts/how-many-amps-does-a-diesel-heater-use.md	how-many-amps-does-a-diesel-heater-use
content/posts/5-space-heaters-you-can-leave-unattended-reliable-safe.md	space-heaters-you-can-leave-unattended
content/posts/how-long-does-a-20lb-propane-tank-last.md	how-long-does-a-20lb-propane-tank-last
content/posts/can-you-put-a-space-heater-on-a-table.md	can-you-put-a-space-heater-on-a-table
content/posts/when-to-replace-your-air-conditioner-3-rules-of-thumb.md	when-to-replace-air-conditioner
content/posts/21-cheapest-ways-to-heat-a-room-house.md	the-21-cheapest-ways-to-heat-a-room
content/posts/electric-kettle-keeps-boiling-doesn-t-shut-off-how-to-fix-it.md	fix-electric-kettle-keeps-boiling-doesnt-shut-off
content/posts/are-electric-fireplaces-energy-efficient.md	are-electric-fireplaces-energy-efficient
content/posts/electric-heater-e1-error-how-to-fix-it.md	how-to-fix-electric-heater-e1-error
content/posts/how-to-fix-an-air-purifier-not-turning-on.md	how-to-fix-an-air-purifier-not-turning-on
content/posts/swamp-cooler-vs-air-conditioner-cost-comparison.md	swamp-cooler-vs-air-conditioner-comparison
content/posts/3-space-heaters-that-don-t-dry-the-air.md	space-heaters-that-dont-dry-the-air
content/posts/do-space-heaters-save-money.md	do-space-heaters-save-money
content/posts/blue-flame-vs-infrared-heater-which-is-better.md	blue-flame-vs-infrared-heater
content/posts/3-best-oil-heaters-you-can-leave-on-all-night.md	3-best-oil-heaters-you-can-leave-on-all-night
content/posts/5-safety-tips-for-using-a-space-heater-in-a-bathroom.md	5-safety-tips-for-using-a-space-heater-in-a-bathroom
content/posts/how-to-dispose-of-a-space-heater.md	how-to-dispose-of-a-space-heater
content/posts/how-to-fix-a-vornado-heater-not-working.md	how-to-fix-a-vornado-heater-not-working
content/posts/how-much-do-infrared-heaters-cost-to-run.md	how-much-do-infrared-heaters-cost-to-run
content/posts/5-effective-ways-to-heat-a-garage-without-insulation.md	5-ways-to-heat-a-garage-without-insulation
content/posts/are-vornado-fans-worth-it-vortex-power-or-marketing-hoax.md	are-vornado-fans-worth-it
content/posts/4-best-shed-heaters-gas-electric.md	best-shed-heaters
content/posts/how-to-keep-heat-in-a-room-without-a-door-21-helpful-tips.md	how-to-keep-heat-in-a-room-without-a-door-21-helpful-tips
content/posts/5-best-air-purifiers-for-small-rooms.md	best-air-purifiers-for-small-rooms
content/posts/are-dyson-air-purifiers-worth-the-money.md	are-dyson-air-purifiers-worth-the-money
content/posts/swamp-cooler-making-noise-7-fixes.md	swamp-cooler-making-noise-fixes
content/posts/5-best-space-heaters-for-garages.md	best-space-heaters-for-garages
content/posts/space-heater-vs-electric-blanket-21-pros-and-cons.md	space-heater-vs-electric-blanket-21-pros-and-cons
content/posts/infrared-vs-oil-heater-21-pros-and-cons.md	infrared-vs-oil-heater-21-pros-and-cons
content/posts/do-swamp-coolers-need-open-windows.md	do-swamp-coolers-need-open-windows
content/posts/diesel-heater-not-getting-hot-12-fixes.md	diesel-heater-not-getting-hot
content/posts/are-wood-stove-inserts-worth-it-when-does-it-pay-off.md	are-wood-stove-inserts-worth-it
content/posts/how-to-heat-a-cabin-without-electricity-5-methods.md	how-to-heat-a-cabin-without-electricity
content/posts/are-space-heaters-safe-for-cats.md	are-space-heaters-safe-for-cats
content/posts/can-you-run-a-space-heater-off-a-car-battery.md	can-you-run-a-space-heater-off-a-car-battery
content/posts/are-pelonis-heaters-safe-a-critical-review.md	are-pelonis-heaters-safe
content/posts/where-to-place-an-infrared-heater-3-example-placements.md	where-to-place-an-infrared-heater
content/posts/heating-a-wedding-tent-the-ultimate-guide.md	heating-a-wedding-tent-the-ultimate-guide
content/posts/will-a-space-heater-dehumidify-a-room.md	will-a-space-heater-dehumidify-a-room
content/posts/can-you-use-a-portable-ac-when-it-s-smoky-outside.md	can-you-use-portable-ac-when-smoky-outside
content/posts/5-quietest-portable-air-conditioners-47db-52db.md	quietest-portable-air-conditioners
content/posts/how-to-get-heat-upstairs-a-detailed-guide.md	how-to-get-heat-upstairs-a-detailed-guide
content/posts/how-to-fix-a-portable-ac-not-turning-on.md	how-to-fix-portable-ac-not-turning-on
content/posts/why-is-my-oil-filled-radiator-not-getting-hot-6-fixes.md	oil-filled-radiator-not-getting-hot
content/posts/are-delonghi-portable-air-conditioners-good.md	delonghi-portable-air-conditioner-good
content/posts/how-to-keep-a-portable-air-conditioner-hose-from-falling-out.md	portable-air-conditioner-hose-falling-out
content/posts/dyson-drip-tray-overflow-error-how-to-fix-it.md	fix-dyson-drip-tray-overflow-error
content/posts/20-cheapest-ways-to-cool-a-room-and-house.md	cool-room-house-cheap
content/posts/how-to-insulate-a-window-ac-for-efficiency.md	how-to-insulate-a-window-ac
content/posts/how-to-heat-a-large-room-methods-and-cost.md	how-to-heat-a-large-room
content/posts/can-you-use-an-extension-cord-with-an-air-purifier.md	can-you-use-an-extension-cord-with-an-air-purifier
content/posts/can-you-run-an-infrared-heater-overnight.md	can-you-run-an-infrared-heater-overnight
content/posts/electricity-usage-of-oil-filled-heaters-the-ultimate-guide.md	electricity-usage-of-oil-filled-heaters-the-ultimate-guide
content/posts/why-is-infrared-hotter-than-visible-light.md	why-is-infrared-hotter-than-visible-light
content/posts/are-air-purifiers-safe-for-pets-dogs-cats-birds-etc.md	are-air-purifiers-safe-for-pets
content/posts/dyson-h2-error-code-how-to-fix-it.md	dyson-h2-error-code-fix
content/posts/blueair-blue-211-review-is-it-worth-it.md	blueair-blue-211-review
content/posts/propane-heater-keeps-shutting-off-7-fixes.md	propane-heater-keeps-shutting-off
content/posts/can-solar-panels-power-a-heat-pump.md	can-solar-panels-power-heat-pump
content/posts/do-portable-air-conditioners-give-off-carbon-monoxide.md	portable-air-conditioner-carbon-monoxide
content/posts/can-you-burn-coal-in-a-wood-stove.md	can-you-burn-coal-in-a-wood-stove
content/posts/air-purifier-keeps-shutting-off-7-reasons-fixes.md	fix-air-purifier-keeps-shutting-off
content/posts/are-infrared-heaters-safe-indoors.md	are-infrared-heaters-safe-indoors
content/posts/how-long-does-a-420lb-propane-tank-last.md	how-long-does-a-420lb-propane-tank-last
content/posts/dyson-fan-not-rotating-7-fixes.md	dyson-fan-not-rotating
content/posts/9-ways-to-heat-a-room-without-electricity.md	how-to-heat-room-without-electricity
content/posts/can-you-use-a-space-heater-for-a-sauna.md	can-you-use-a-space-heater-for-a-sauna
content/posts/how-long-does-a-100lb-propane-tank-last.md	how-long-does-a-100lb-propane-tank-last
content/posts/can-portable-air-conditioners-run-24-7.md	can-portable-air-conditioners-run-continuously
content/posts/how-to-use-a-dyson-hot-cool-without-the-remote.md	how-to-use-dyson-hot-cool-without-remote
content/posts/how-to-make-a-portable-air-conditioner-quiet.md	how-to-make-a-portable-air-conditioner-quiet
content/posts/can-you-use-a-gas-stove-as-a-heater.md	can-you-use-a-gas-stove-as-a-heater
content/posts/how-to-use-a-diesel-heater-indoors-the-complete-guide.md	how-to-use-a-diesel-heater-indoors
content/posts/can-you-use-a-surge-protector-with-a-space-heater.md	can-you-use-a-surge-protector-with-a-space-heater
content/posts/air-purifier-making-noise-8-noises-fixes.md	air-purifier-making-noise-fixes
content/posts/window-ac-making-noise-9-fixes.md	window-ac-making-noise-fixes
content/posts/propane-vs-electric-space-heater-which-is-better.md	propane-vs-electric-space-heater
content/posts/how-to-fix-space-heater-smell-plastic-burning.md	how-to-fix-space-heater-smell
content/posts/dyson-big-quiet-review-high-price-high-performance.md	dyson-big-quiet-review
content/posts/how-much-power-does-a-heat-pump-use-1-5-tons.md	how-much-power-does-a-heat-pump-use
content/posts/why-is-my-propane-heater-using-so-much-gas.md	why-is-propane-heater-using-so-much-gas
content/posts/do-space-heaters-burn-oxygen.md	do-space-heaters-burn-oxygen
content/posts/how-long-does-a-propane-tank-last-on-a-patio-heater.md	how-long-does-a-propane-tank-last-on-a-patio-heater
content/posts/13-ways-to-improve-wood-stove-efficiency.md	how-to-improve-wood-stove-efficiency
content/posts/portable-air-conditioner-running-cost-ultimate-guide.md	portable-air-conditioner-running-cost
content/posts/space-heater-making-noise-6-sound-samples-fixes.md	space-heater-making-noise-fixes
content/posts/what-space-heaters-are-safe-for-birds.md	what-space-heaters-are-safe-for-birds
content/posts/can-space-heaters-explode.md	can-space-heaters-explode
content/posts/can-you-run-an-air-purifier-and-a-humidifier-at-the-same-time.md	can-you-run-air-purifier-and-humidifier-at-the-same-time
content/posts/how-to-install-a-wood-stove-in-a-mobile-home.md	how-to-install-a-wood-stove-in-a-mobile-home
content/posts/how-to-fix-a-space-heater-cord-getting-hot.md	how-to-fix-a-space-heater-cord-getting-hot
content/posts/space-heater-makes-clicking-noise-2-common-reasons-for-the-popping.md	space-heater-makes-clicking-noise
content/posts/how-to-make-a-portable-air-conditioner-more-efficient.md	how-to-make-portable-air-conditioner-more-efficient
content/posts/why-does-your-portable-air-conditioner-collect-no-water.md	portable-air-conditioner-collects-no-water
content/posts/are-tower-fans-better-than-pedestal-fans-answer-no.md	are-tower-fans-better-than-pedestal-fans
content/posts/do-propane-heaters-need-electricity.md	do-propane-heaters-need-electricity
content/posts/can-you-run-two-space-heaters-at-once-experiment-confirmed.md	can-you-run-two-space-heaters-at-once
content/posts/3-most-powerful-space-heaters.md	most-powerful-space-heaters
content/posts/how-to-vent-a-portable-ac-without-a-window.md	how-to-vent-portable-ac-without-window
content/posts/evaporative-cooler-not-turning-on-7-fixes.md	evaporative-cooler-not-turning-on
content/posts/what-s-the-difference-between-a-window-vs-split-ac.md	whats-the-difference-between-window-ac-and-split-ac
content/posts/can-you-use-a-window-air-conditioner-without-a-window.md	use-window-air-conditioner-without-window
content/posts/best-space-heaters-not-hot-to-touch.md	best-space-heaters-not-hot-to-touch
content/posts/can-candles-cause-carbon-monoxide-poisoning.md	can-candles-cause-carbon-monoxide-poisoning
content/posts/how-many-candles-do-you-need-to-heat-a-room.md	how-many-candles-do-you-need-to-heat-a-room
content/posts/diesel-heater-fuel-gelling-4-fixes.md	fix-diesel-heater-fuel-gelling
content/posts/3-best-propane-heaters-for-high-altitude.md	best-propane-heaters-for-high-altitude
content/posts/space-heater-not-blowing-hot-air-how-to-fix-it.md	space-heater-not-blowing-hot-air
content/posts/how-long-do-oil-filled-radiators-last.md	how-long-do-oil-filled-radiators-last
content/posts/can-you-put-a-space-heater-on-carpet.md	can-you-put-a-space-heater-on-carpet
content/posts/do-space-heaters-emit-carbon-monoxide.md	do-space-heaters-emit-carbon-monoxide
content/posts/are-wood-stove-fans-worth-it.md	are-wood-stove-fans-worth-it
content/posts/can-you-run-two-portable-acs-at-once.md	can-you-run-two-portable-air-conditioners-at-once
content/posts/best-vented-propane-heater-without-electricity.md	best-vented-propane-heater-without-electricity
content/posts/3-best-swamp-coolers-for-garages.md	best-swamp-coolers-for-garages
content/posts/how-to-heat-a-walk-in-closet-in-4-simple-steps.md	how-to-heat-a-walk-in-closet-in-4-simple-steps
content/posts/how-much-does-a-space-heater-cost-to-run-21-heaters-tested.md	space-heater-electricity-cost-a-look-at-the-costs-of-21-different-models
content/posts/how-long-can-you-run-a-dyson-heater.md	how-long-can-you-run-a-dyson-heater
content/posts/3-best-space-heaters-for-hot-yoga.md	best-space-heaters-for-hot-yoga
content/posts/space-heater-smoking-4-fixes-nbsp.md	space-heater-smoking-fixes
content/posts/can-you-run-a-space-heater-off-a-solar-panel.md	can-you-run-space-heater-off-solar-panel
content/posts/can-you-run-an-air-purifier-24-7.md	can-you-run-air-purifier-all-day
content/posts/best-space-heaters-for-the-office.md	best-space-heaters-for-the-office
content/posts/are-mr-heaters-any-good-critical-review.md	are-mr-heater-buddy-heaters-any-good
content/posts/propane-heater-making-noise-7-fixes.md	propane-heater-making-noise
content/posts/are-vornado-heaters-energy-efficient.md	are-vornado-heaters-energy-efficient
content/posts/dyson-f3-error-code-how-to-fix-it.md	dyson-f3-error-code-fix
content/posts/can-ventless-heaters-cause-carbon-monoxide-poisoning.md	can-ventless-heaters-cause-carbon-monoxide-poisoning
content/posts/what-is-the-safest-propane-heater.md	whats-the-safest-propane-heater
content/posts/how-to-heat-a-room-without-a-heater.md	how-to-heat-room-without-heater
content/posts/can-you-run-a-portable-ac-off-a-generator.md	run-portable-air-conditioner-off-generator
content/posts/can-a-swamp-cooler-catch-on-fire.md	can-a-swamp-cooler-catch-on-fire
content/posts/can-i-use-an-extension-cord-with-a-space-heater.md	can-i-use-an-extension-cord-with-a-space-heater
content/posts/ceramic-vs-infrared-heater-which-is-more-energy-efficient.md	ceramic-vs-infrared-heater-efficiency
content/posts/how-to-fix-a-window-air-conditioner-not-cooling.md	how-to-fix-window-air-conditioner-not-cooling
content/posts/how-to-fix-an-infrared-heater-not-working.md	how-to-fix-an-infrared-heater-not-working
content/posts/dyson-fan-warning-triangle-5-fixes.md	dyson-fan-warning-triangle-error-fixes
content/posts/can-you-run-a-wood-stove-pipe-through-a-window.md	can-you-run-wood-stove-pipe-through-window
content/posts/nuwave-oxypure-review-exceptional-filtration-poor-monitoring.md	nuwave-oxypure-review
content/posts/do-oil-heaters-need-to-be-refilled.md	do-oil-heaters-need-to-be-refilled
content/posts/how-to-fix-a-dyna-glo-heater-not-lighting.md	how-to-fix-a-dyna-glo-heater-not-lighting
